RMIL markup language

UI components

al: Alert
cm: Command
cg: ChoiceGroup
cv: Canvas
df: DateField
ds: Display
fr: Form
gg: Gauge
ii: ImageItem
li: ListItem
ls: List
si: StringItem
sp: Spacer
tb: TextBox
tc: Ticker
tf: TextField
zk: zk

Attributes

bc: BACK command
cc: CANCEL command
cr: current
cs: constraints
di: desktop id
ec: EXIT command
fn: font
fp: fitPolicy
hc: HELP command
ic: indicator
id: id
im: image
in: ITEM command
it: interactive
iv: initialValue
lb: label
ll: longLabel
lo: layout
md: mode, appearanceMode, initialInputMode
mh: minHeight
ms: minimumSize
mw: minWidth
mv: maxValue
oc: OK Command
og: onChanging
ol: onSlide
on: onChange
os: onSelect
pr: priority
ps: preferredSize
sc: SCREEN command
si: selectedIndex
sm: SELECT command (special for List and ChoiceGroup)
sn: STOP command
to: timeout
tp: type, alertType, choiceType, listType
tt: title
tx: text, altText, string
tz: timezone
xs: maxSize
za: zk_action
zp: zk_procto
zt: zk_tipto
zv: zk_ver

AlertType

al: AlertType.ALARM;
cf: AlertType.CONFIRMATION;
er: AlertType.ERROR;
if: AlertType.INFO;
wn: AlertType.WARNING;
